SHK = "countries/Shamkhalate_of_Tarki.txt"
NDL = "countries/Nordland.txt"
KOS = "countries/Kostroma.txt"
VLD = "countries/VladimirSuzdal.txt"
UGL = "countries/Uglich.txt"
BZK = "countries/Beloozersk.txt"
YOT = "countries/Yotvings.txt"
PTV = "countries/Pinsk-Turov.txt"
MRM = "countries/Murom.txt"

ARC = "countries/Argentine_Confederation.txt"
LIB = "countries/Liberia.txt"
NDB = "countries/NorddeutscherBund.txt"
CGU = "countries/ChagataiUlus.txt"
HUL = "countries/Ilkhanate.txt"
INJ = "countries/Injuids.txt"
KTR = "countries/Kotor.txt"
CHB = "countries/Chobanids.txt"
JAL = "countries/Jalayirids.txt"
THS = "countries/Thessalia.txt"
CRM = "countries/CilicianArmenia.txt"
SGT = "countries/SerbiaGreeceTsardom.txt"

BDR = "countries/Bardak.txt"
BRY = "countries/Bryansk.txt"

HEM = "countries/Helm.txt"
TOR = "countries/Toropets.txt" 
RIL = "countries/Rilsk.txt" 
PIN = "countries/Pinsk.txt" 
OVR = "countries/Ovruch.txt" 
NSI = "countries/Novosil.txt" 
MIS = "countries/Minsk.txt" 
LUT = "countries/Lutsk.txt" 
KRM = "countries/Karachev.txt" 
VIT = "countries/Vitebsk.txt"
GLU = "countries/Gluhov.txt" 
KIN = "countries/Kashin.txt"
MLN = "countries/Mikulin.txt"
BLZ = "countries/Belz.txt"
STR = "countries/Starodub.txt" 
SUZ = "countries/Suzdal.txt"
VYZ = "countries/Vyazma.txt"
KUJ = "countries/Kujavia.txt" 
SAM = "countries/Samogitia.txt"  
VID = "countries/Vidin.txt"    
DOB = "countries/Dobrudza.txt" 
VVL = "countries/Vladimirvolyn.txt"  
DMI = "countries/Dmitrov.txt"
VLK = "countries/Volokolamsk.txt"  
ELE = "countries/Elets.txt" 
MLG = "countries/Mologa.txt" 
DRB = "countries/Dorogobug.txt" 
YUA = "countries/Yuan.txt" 

SAN = "countries/Sandomir.txt" 
KIS = "countries/Kalish.txt"
GNE = "countries/Gnezno.txt"
MUZ = "countries/Muzaffarids.txt"
KRT = "countries/Kartids.txt"
SAB = "countries/Shabankara.txt"
SDB = "countries/Sarbadars.txt"
